0101101010000010
0100011110001101
0100000111111000
0100000001111111
0100000000011111
0100000000000111
0100000000000001
0100000000000000
0100000000000000
0100000000000000
0100000000000000
0100000000000000
0100000000000000
0100000000000000
0100000000000000
0100000000000000